 MMMMM,
MMPOOMMMM,
MPPCPPPPM,
MPPPMCMPM,
MPPJPOCPM,
MMMMMMMMM,