MMMMMMMMMM,
MPPPPPPPPM,
MPJPPPPPPM,
MPPPPPPPPM,
MPCPPPOPPM,
MPPPPPPPPM,
MMMMMMMMMM,