------MMMM,
MMMMMMMPPMM,
MJCPPPPPPPM,
MPGMMMPPMPM,
MMOOPPPPMPM,
MMGMPPPPPPM,
MPCPPMMMMMM,
MPPPMM,
MMMMM,