MMMMMMMMMMMM,
MOOPPMPPPPPM,
MOOPPMPMMPPM,
MOOPPPPPMPPM,
MOOPPMPCMMPM,
MOOPPMCPMPPM,
MMMMMMPPMCPM,
--MPPCPCCPPM,
-MMPCCCPPMPM,
-MJPCPMMPPPM,
-MMPPPPPPPPM,
--MMMMMMMMMM,