---MMMMM,
---MPPPM,
---MPCCMMMM,
---MPPCPCPM,
---MPCMPPPM,
MMMMPPMMCPMMMMMM,
MJPPPPMMPPPPPOOM,
MMPPPPPPPPPPPOOM,
-MMMMMMMMMMMPOOM,
-----------MMMMM,