------MMMMMM,
-MMMMMMPPPPMMM,
MMPPOPPPPPPPPM,
MJPMMPPCPMPCPM,
MMPOPPCMPCCMPM,
MPPMPMPCCMPPPM,
MPPOOMPPPPPMMM,
MPPOMMMMMMMM,
MMPOOM,
-MMMMM