----MMMMM
----MPPPM
----MCPPM
--MMMPPCMMM
--MPPCPPCPM
MMMPMPMMMPM-----MMMMMM
MPPPMPMMMPMMMMMMMPPOOM
MPCPPCPPPPPPPPPPPPPOOM
MMMMMPMMMMPMJMMMMPPOOM
----MPPPPPPMMM--MMMMMM
----MMMMMMMM