------------MMMMMMM,
------MMMM--MPPMPPMMMMMMM,
------MPPMMMMPPMPPPPPPPPM,
MMMMMMMMPPCPPPPMPMPPPMPPM,
MPPPPPOMPCCCMMCMOMMMMMPMM,
MPPPPPPPPPPPMPPMPMPPPMPPM,
MPPMMMOMPMMMMCPPPPPOPPPPM,
MMMM-MMMPPOPCPPPMMMMPPCMM,
------MJPPMPPPPMM--MMPPM,
------MMMOOOPMMM----MMMM,
--------MMMMMM,