MMMMMMM,
MPPPPPM,
MOGGGGMM,
MPPPPPPM,
MMMMPPPM,
---MCCOM,
---MJPMM,
---MMMM,