-MMMM,
MMPPMMMM,
MPPPCPPM,
MPCCMJPM,
MPCPMMPM,
MPPPPMOM,
MMPCPOOM,
-MMPPOOM,
--MMMMMM