-MMMMMMMM,
-MPPMMPPM,
-MOCPPPOMMM,
-MPOMMPCPPM,
MMCMMMPMPPM,
MPCPPPPMPMM,
MPJPMOPPPPM,
MMMMMMMPPPM,
------MMMMM,