MMMMMMMMMMMMMM,
MPPPPPPPPPPPPM,
MPPPMMMMMMMPMM,
MPCPCPPPCPPPPM,
MPPMMPMPPPMPPM,
MPMMPPMMMMMPMM,
MPPPPPPPPPPPPM,
MPPPPPPPPCPPPM,
MOJOMMMMCMMPMM,
MOOOM--MPPPPM,
MMMMM--MMMMMM,