-MMMMMMM,
MMPPPPMMMMMMMM,
MPPMPCPMMPPPOM,
MPCMPMPMPPPOOM,
MPPCPPPPPPCOOM,
MMMMPMPMMMMJOM,
--MPPMCMM-MMMM,
--MPCPPPM,
--MMMPPPM,
----MMMMM,