MMMMM-MMMM, 
MPPPMMMPP M,
MPCPPPPPJM,
MMCGGGGGCMM,
MPCOOOOOCPM,
MPPPMPPPPPM,
MMMMMMMMPPM,
-------MMMM,