-MMMM,
-MPPMMMMMMMM,
-MCPMPPPPPPM,
MMPPPPPPMMPM,
MPOCMJMPPPPM,
MOCPMMMMMMMM,
MPOMM,
MMMM,