-MMMMMMM,
-MJPPPPM,
-MPPMPPMMMMMMMMMMMM,
-MPMMMPPCPPPPPPCPPM,
MMPPMPPPMPCMCPCMCPM,
MOOOOPPPPPPCPCPPCPM,
MOOOMMMMPCMCPMPCMPM,
MOOOM--MPPPPPPPPPPM,
MMOOM--MMMMMMMMMMMM,
-MMMM,