MMMMMMMM,
MPPPMPPM,
MPMPMCOM,
MPPPPCOM,
MPMPMCOM,
MPPPMPPM,
MMMMMJPM,
----MMMM,