-------MMMM,
-------MPPM,
MMMMMMMMCPM,
MPPCPPPPPPM,
MPPMMMMMCPM,
MPPPPPPPPPM,
MPPMMMMMPPM,
MPPPPPOMPPM,
MPPPPOMMPPM,
MPPMOMMPPPM,
MJPPMMPPPPM,
MMPPPPPPPMM,
-MMMMMMMMM